           TTTTT  SB  CTTTTT
  P           L LTTTTTLTTTTT
TTTLTTTTL  TTTLTT     L  TTT
   L S  LLB   L       L  TTT
TTTTTTTTLTTTTTTTTTTTTLL  TTT
        L            TTTTTTT
      S L S            BCTTT
 B   LTTTTTTTTTTTTTTTTTTTTTT
TTTLTT                      
   LTTTTTTTTTTTTTTTTTTTTTTTT
   L                        
S              C       BBBCD
TTTTTTTTTTTTTTTTTTTTTTTTTTTT