TTTTTTTTTTTTTTTTTTTTTTTTTTTT
T P                  C     T
TTTTLLLLLLLLLLLLLLLLLLLLTTTT
T      C     B     S       T
TLTTTTLTTTTTTTTTTTTTTTTLTTTT
 LB   LB               L   B
TTT   TT  T   T T   T TTTTTT
TS T T  T TT  T T   T T  S  
TTTT T  T T T T T   T TTTTTT
TS T T  T T  TT T STT    S T
TTT   TT  T   T TTT T TTTTTT
    D    S       C     S    
TTTTTTTTTTTTTTTTTTTTTTTTTTTT