TTTTTTTTTTTTTTTTTTTTTTTTTTTT
TTP    B    S            TTT
TTTTTTTTTTTTTTTTTTTTTTT  TTT
                         TTT
    B    S    C       B  TTT
 TL  TTTTTTTTTTTTTTTTTTTTTTT
 TL  TTLLLL     S   TTBTTTTT
 TTTT  L   TTTTTTTTL  L CTTT
   C LTTTTL B     TTTTTTTTTT
TTTTTTTTTTTTTTTT     LLLLLLT
TTTTTTTTTTTTTTTTTTTTTT B BLT
C             D     C     LT
TTTTTTTTTTTTTTTTTTTTTTTTTTTT