TTTTTTTTTTTTTTTTTTTTTTTTTTTT
T  B  P     S  S        B  T
T  TTTTLTTTTTTTTTTTTLTTTT  T
T  T   L    S  S    L   T  T
T  T  TTTLTTTTTTTTLTTT  T  T
T  T  T  L   BB   L  T  T  T
T  T  T  LTTTTTTTTL  T  T  T
T  T  TC L  S  S  L CT  T  T
T  T  TTTTTTTLLTTTTTTT  T  T
T  TB        LL        BT  T
T  TLTTTTTTTTTTTTTTTTTTLT  T
TC  L S       D   S    L  CT
TTTTTTTTTTTTTTTTTTTTTTTTTTTT