TTTTTTTTTTTTTTTTTTTTTTTTTTTT
T P                  C     T
TTTTLLLLLLLLLLLLLLLLLLLLTTTT
T      C     B     S       T
TLTTTTLTTTTTTTTTTTTTTTTLTTTT
 LB   LB               L   B
TTTL  TT  T   T T   T TTTTTT
TS TLT  T TT  T T   T T  S  
TTTTLT  T T T T T   T TTTTTT
TS TLT  T T  TT T STT    S T
TTT L TT  T   T TTT T TTTTTT
    LD   S       C     S    
TTTTTTTTTTTTTTTTTTTTTTTTTTTT